In JavaScript, an array is a special type of object used to store an ordered collection of values. These values, known as elements, are accessed using a numeric index, starting from 0 for the first element.
Here's a breakdown of key aspects of JavaScript arrays:

1. Creation:
Array Literal (most common).
  const fruits = ["Apple", "Banana", "Orange"];
  array constructor.
  const numbers = new Array(1, 2, 3);

2. Characteristics:
    Ordered: Elements maintain their insertion order.
    Zero-indexed: The first element is at index 0.
    Dynamic Size: Arrays can grow or shrink as elements are added or removed. 
    Heterogeneous: Arrays can store elements of different data types (numbers, strings, objects, other arrays, etc.) within the same array. 
    Objects: Arrays are technically objects in JavaScript, inheriting properties and methods from Array.prototype.


3. Accessing Elements:
        Elements are accessed using square bracket notation with their index:
        const colors = ["Red", "Green", "Blue"];
        console.log(colors[0]); // Output: Red


4. Common Array Properties and Methods:
        length property: Returns the number of elements in the array.
        const items = [10, 20, 30];
        console.log(items.length); // Output: 3
            
        push(): Adds one or more elements to the end of an array.
        pop(): Removes the last element from an array.
        shift(): Removes the first element from an array.
        unshift(): Adds one or more elements to the beginning of an array.
        concat(): Joins two or more arrays.
        slice(): Extracts a section of an array.
        splice(): Changes the contents of an array by removing or replacing existing elements and/or adding new elements.
        forEach(): Executes a provided function once for each array element.
        map(): Creates a new array populated with the results of calling a provided function on every element in the calling array.
        filter(): Creates a new array with all elements that pass the test implemented by the provided function.
        reduce(): Executes a reducer function on each element of the array, resulting in a single output value.


        const myArray = [1, 2, 3];
        myArray[0] = 5; // Modifies the element at index 0
        console.log(myArray); // Output: [5, 2, 3]